NO assets/N.png
SO assets/S.png
WE assets/W.png
EA assets/E.png

F 255,166,170
C 219,166,255

111111CC11111100011
1E00000000000010101
0C000000000000010001
001000011110000000001
01000000000000000001
100000011110000000C
C000000000C00000001
1000001000100000001
1000010100100000001
C1C1100011111111111
