NO assets/N.png
SO assets/S.png
WE assets/W.png
EA assets/E.png

F 220,100,0
C 225,30,0

1111111111111111
1000000000000001
01000000000000001
001000000000000001
01000000N00000001
1000000111000001
1000000000000001
1000000000000001
1000000000000001
1111111111111111
