NO assets/N.png
SO assets/S.png
WE assets/W.png
EA assets/E.png

F 220,100,0
C 225,30,0

1111111111111100011
1000000000000010101
01000000000000010001
001000011110000000001
01000000N00000100001
1000000111100101001
1000000000100010001
1000001000100000001
1000010100100000001
1111100011111111111
