NO          assets/default/N.png
EA assets/default/E.png
SO                                 assets/default/S.png
WE assets/default/W.png

F 220,100,0
C  225,30,0

                                   11111111111111111111111111111111111111111111111111111111111111
                                   10000000000000000000000000000000000000000000000000000000000001
                                   10000S00000000000000000000000000000000000000000000000000000001
                                   10000000000000000000000000000000000000000000000000000000000001
                                   10000000000000000000000000000000000000000000000000000000000001
            1111111111111111111111110000000000000000000000000D00000000000000000000000000000000001
            1000000000000000000000000000000000000000000000000000000000000000000000000000000000001
            1011111111111111111111110000000000000000000000000000000000000000000000000000000000001
            101                    10000000000000000000000000000000000000000000000000000000000001
            101                    10000000000000000000000000000000000000000000000000000000000001
            101                    10000000000000000000000000000000000000000000000000000000000001
            101                    10000000000000000000000000000000000000000000000000000000000001
            101                    10000000000000000000000000000000000000000000000000000000000001
            101                    10000000000000000000000000000000000000000000000000000000000001
            101                    10000000000000000000000000000000000000000000000000000000000001
            101                    10000000000000000000000000000000000000000000000000000000000001
            101                    10000000000000000000000000000000000000000000000000000000000001
            101                    10000000000000000000000000000000000000000000000000000000000001
1111111111111011111111111111111111110000000000000000000000000000000000000000000000000000000000001
1000000000000000000000000000000000000000000000000000000000000111111111111111111111111111111111111
10000000000000000000000000000000000000000000000000000000000001
10000000000000000000000000000000000000000000000000000000000001
10000000000000000000000000000000000000000000000000000000000001
10000000000000000000000000000000000000000000000000000000000001
10000000000000000000000000000000000000000000000000000000000001
10000000000000000000000000000000000000000000000000000000000001
10000000000000000000000000000000000000000000000000000000000001
10000000000000000000000000000000000000000000000000000000000001
10000000000000000000000000000000000000000000000000000000000001
10000000000000000000000000000000000000000000000000000000000001
10000000000000000000000000000000000000000000000000000000000001
10000000000000000000000000000000000000000000000000000000000001
10000000000000000000000000000000000000000000000000000000000001
10000000000000000000000000000000000000000000000000000000000001
10000000000000000000000000000000000000000000000000000000000001
10000000000000000000000000000000000000000000000000000000000001
10000000000000000000000000000000000000000000000000000000000001
10000000000000000000000000000000000000000000000000000000000001
10000000000000000000000000000000000000000000000000000000000001
11111111111111111111111111111111111111111111111111111111111111
