NO assets/default/N.png
SO assets/default/S.png
WE assets/default/W.png
EA assets/default/E.png

F 171,235,198
C 255,166,170

111111111111111111111
100000000100001000001
101111110100001000001
100000000100101000001
100000000100101000001
100111111100101000001
100010101000111111001
10000010101110000001
1000000000000100000011111111111
1111111111100101010101010E00001
          100100010000000100001
          100100011010100100001
          101111110010000100001
          1000100101 1010101001
          100010010010010101001
          100010111111010001001
          100010111111010001001
          100010000000010001001
          100000000000000000001
          111111111111111111111











