NO assets/maze/basic_wall.png
SO assets/maze/basic_wall.png
WE assets/maze/basic_wall.png
EA assets/maze/basic_wall.png

F 138,101,35
C 138,101,35

1C111111111111111111111111111111111111111
1S100010001000100000000000001000100000001
10000020001100101213121312101310111110111
10001010101000001000100000100010000010001
10021010100000111000111011100011100010101
10001010100010001010001000001010001000101
10111010121312101011101111101011D11111101
10100010001000101000300000103000000000101
10200111101000101120111110112113112110101
10100000100010D00010100010100010100000101
10100110D00110101110101010100010101111101
10200010100010100030101010001000001000001
10110010113110111010101011111012121010111
10100010100000001010001000001000101010101
10101110100211112021112111201110101010101
1010100010001000100010000010D010D00010101
10111011110010001100101110101010111110101
10001010100010100000101000101000100000101
100010D00001101111D1101011101011101212101
1010101000003010000010D000101010100000001
11101011121010111000101110101000112100101
10001000001010001010101000101000100000101
10121110001013101012101013101212100011101
10100010101000101000101010000010001010101
10D00110111100101100101110111010131010101
10100010000000101000100000101000100010001
1021001121131121101121211010101111D111101
10100010001000001010001000001000100000001
1020111100201100D000001211131112101111111
10101000001010001000100000001010001000001
100010011110113111001111D1101000111000001
10002000101000000000001000100000100010101
10011100D01111111111001000112113112110101
10001000100000100010001010000000000000101
111000112310001000100000121121D1110011101
101000100010101030101000D0000000100010001
10201110002010111010111110111110111111101
10101010101010000010000010100020001000101
10000010121010011210310000100011001000001
10000010000010000000100000101000001010001
111111111111111111111111111111111111111G1
