NO assets/maze/basic_wall.png
SO assets/maze/basic_wall.png
WE assets/maze/basic_wall.png
EA assets/maze/basic_wall.png

F 138,101,35
C 138,101,35

1C121113112111112112131111211311211111211
10100010001000100000000000001000100000001
1N00002000130010121312D312101310121210111
20001030D01000002000100000300010000020001
1002101020000013100012D011100011100010101
10001030D00010001010001000002010001000101
101210101213D2101031101212101011D12132101
20100010001000102000300000103000000000101
1020011D101000101220213120112113112110101
10100000200010D00010100010100010100000101
30100210D001201013103010D0100010101111101
10200010100010100030101010001000001000001
20120010113120111010201012131012121010111
10100010300000001010001000001000101010101
10101210100213112021212131201110101010101
1010D00010002000100010000010D010D00010101
1011101D3100D0002D00301310103010121210101
3000101010002010000010D000101000100000101
100010D0000D101121D1101011102011101212101
1010101000003010000020D000101010100000001
3D10101D121010121000101110102000112100101
10001000003020001010201000101000100000101
20121D10001013102012101013101212100011101
1010001010300010D000101010000010001010101
30D0011021D2001012002013101D1010131010101
10100020000000101000100000101000100010001
102D00312113112D201121211010101D11D111101
20100010001000002010001000001000100000001
10201D1100201100D000001211131112101211121
2010100000D010003000100000001010001000001
100010013130113111001111D1101000131000001
10002000101000000000001000100000100010101
20011100D01211311121001000112113112110101
10001000100000100010001010000000000000101
111000112310001000200000121121D1110011101
102000D00010101030101000D0000000100010001
202013100020101D101012121011111011D111101
1010101010D020000010000010100020001000101
10000010121010011210310000100011001000001
20000010000020000000100000D01000001010001
121111111111121111211111311112111121112G1
