NO assets/maze/1.png
SO assets/maze/1.png
WE assets/maze/1.png
EA assets/maze/1.png

F 138,101,35
C 138,101,35

11111111111111111111
10000000000000000001
10111111111111111001
10100000000000001001
10101111111111101001
10001000000000001001
10101010111110101001
10101010100000101001
10101010101110101001
10001010100000101001
10111010101110111001
10000010100000100001
10111110101010103001
10100000101010100001
101011101010101120E1
10000000100000100001
111111111111111111G1
