NO assets/default/N.png
SO assets/default/S.png
WE assets/default/W.png
EA assets/default/E.png

F 171,235,198
C 255,166,170

1111111111111100011
1E00000000000010101
01000000000000010001
001000011110000000001
01000100000000000001
1000000111100000001
1000010000C00000001
1000001000100000001
1000010100100000001
1111100011111111111
